Instance,B_C1,MPHB,HBA,MPA,EODE,RLTLBO,QQLMPA,GWO,FDB_TLABC,FTO
1,2,6,4,5,1,7,8,10,3,9
2,1,2,4,3,5,8,6,9,7,10
3,1,4,7,3,2,9,5,8,6,10
4,5,4,9,6,2,10,3,7,1,8
5,5,2,9,6,1,8,3,7,4,10
6,3,2,9,1,8,5,4,10,6,7
7,4,3,7,1,6,8,5,9,2,10
8,2,3,9,1,4,8,5,10,6,7
9,4,6,8,5,2,1,7,10,3,9
10,1,2,10,3,7,6,4,8,5,9
11,2,1,7,3,5,6,8,10,4,9
12,3,1,10,2,5,9,4,8,6,7
